OOOOOOOOOOOOOOOOOO
O               OO
OOOOOOOOOOOOOOOO O
O O O O O O O O OO
O O O O O O O OO O
O O O O O O O O OO
O O O O O O O OO O
O O O O O O O O OO
O O O O O O O OO O
O O O O O O O O OO
O O O O O O O OO O
O O O O O O O O OO
O O O O O O O OO O
O O O O O O O O OO
O O O O O O O OO O
O O O O O O O OO O
O  O O O O O O  OO
OOOOOOOOOOOOOOOOOO